
NO xpm/Bricks_22-512x512.xpm
SO  xpm/Bricks_17-512x512.xpm
WE xpm/Bricks_23-512x512.xpm
EA xpm/Bricks_25-512x512.xpm
F 127,127,127
C 9,22,62

1111111
1000001
1000001
1000001
111000111111111111111111111111111111111111111111111111111111111111
100100000000000000000000000000000000000000000000000000000000000001
100000111111111111111111111111111111111111111111111111111111111111
1000001
1000001
1000001
1000001
1000001
10000N1
1111111