   SO  xpm/Bricks_17-512x512.xpm
	     NO		xpm/Bricks_22-512x512.xpm

		WE		xpm/Bricks_23-512x512.xpm
		EA xpm/Bricks_25-512x512.xpm
	    F		70,0,70
		C               55,139,12

111111111
100000001
100000001
1000E0001
100000011
100000001
111111111
