1111111
0010010
1010101
1010110