
   SO  ./path_to_the_north_texture
	     NO ./path_to_the_north_texture


		WE		./path_to_the_north_texture
		EA ./aaa
	    F		74,253,255
		C               9,22,62

111111111
100000001
100000001
1000E0001
100000001
100000001
111111111