111111111111111111
100000000000000001
110001000001110011
111000000000000001
1111000000S0000001
100000000000000001
100000110000000001
100000000000000001
100000000000000001
100000011110000001
111111111111111111
