   SO  xpm/Bricks_25-512x512.xpm
	     NO		xpm/Bricks_22-512x512.xpm

		WE		xpm/Bricks_23-512x512.xpm
		EA xpm/Bricks_17-512x512.xpm
	    F		70,0,70
		C               55,139,12

       11111111
    11100000000111
  110000000000000011
 10000000000000000001
1000000000000000000001
1000000000000000000001
1000000000N00000000001
1000000000000000000001
1000000000000000000001
 10000000000000000001
  110000000000000011
    11100000000111
       11111111